XXXXXXXXXXXX1XXXXXXXXXXXXXXXX
X                           X
X                          LX
X      T  XXXXXXX2XXXXXXXXXXX
X      X                 X  X
X E     X                X  X
XXXXXXXXXXX     S  S   t X  X
Xt           XXXXXXXXXXXXX  X
XXX3M        D  D  D     D @X
XT        XXXXXXXXXXXX   XXXX
XX        XXX           XXXXX
XX  P T  BXXXT         XXXXXX
XXXXXXXXXXXXXXXXXXXXXXXXXXXXX
~~~~~~~~~~~~~~~~~~~~~~~~~~~~~
Above is level, below are the
links.
~~~~~~~~~~~~~~~~~~~~~~~~~~~~~
7:20|5:17
2:14|5:26
7:17|5:14
2:7|5:4
4:2|5:20
7:24|10:18
6:2|10:18
10:8|13:13
7:24|10:18