XXXXXXXXXXXX1XXXXXXXXXXXXXXXX
X                           X
X                          LX
X      T  XXXXXXX2XXXXXXXXXXX
X      X                 X  X
X E     X                X  X
XXXXXXXXXXX     S  S   t X  X
Xt           XXXXXXXXXXXXX  X
XXX3M        D  D  D     D @X
XT        XXXXXXXXXXXX   XXXX
XX        XXX           XXXXX
XX  P T  BXXXT         XXXXXX
XXXXXXXXXXXXXXXXXXXXXXXXXXXXX
