                            XXXXXXXXXXXXXXXXXXXXXXXXXXXXXXX
                            XXXXXX6                      6X
XXXXXXXXXXXXXXXXXXXXXXXXXXXXXXXXXX     q                 @X
XXXXXXXXXXXXXXXXXXXXXXXXXXXXXXX2XX       m           XXXXXX
X6      6X       9        X6   8     XXXXX M        MXXXXXX
X        X       X        X          XXXXXB          XXXXXX
X99      D       X  m S B D mt      BXXXXX99999999999XXXXXX
XXXXXXXXXXXXXXXXXXXXXXXXXXXXXXXXXXXXXXXXXXXXXXXXXXXXXXXXXXX