XXXXXXXXXXXXXXXXXXXXXXXX
X       6X6          66X
X        X             X
XP  m   TX   @         X
XXXXXRRRXXXXXXXXXXXXX  X
X66     6XXXXXXXXXX6   X
X        XXXXXXXXXX    X
X                      X
X         a            X
XL  B            S    MX
XXXXXXXXXXXXX   XXXrrr X
XXXXXXXXXXXXXX  888    X
XXXXXXXXXXXXXXX99999999X
XXXXXXXXXXXXXXXXXXXXXXXX