XXXXXXXXXXXXXXXXXXXXXXXXXXXXX
XXXXXXXX   X1XXXXXXX6     6XX
X6    tX    8              XX
X XXXXXX              L   SXX
X          XXXXXX2XXXXXXXXXXX
X      XX  X6    8      6XXXX
XM    XXXX              tXXXX
XXXXXXXXXXX   s S  S  XXXXXXX
Xt           XXXXXXXXX  6XXXX
XXX4M        D  D eD     DD@X
Xt 8      XXXXXXXXXXXX   XXXX
XX        XXX6          XXXXX
XX P  t   XXXT         XXXXXX
XXXXXXXXXXXXXXXXXXXXXXXXXXXXX