                            XXXXXXXXXXXXXXXXXXXXXXXXXXXXXXX
                            XXXXXX                        X
XXXXXXXXXXXXXXXXXXXXXXXXXXXXXXXXXX                       @X
XXXXXXXXXXXXXXXXXXXXXXXXXXXXXXX2XX       m           XXXXXX
X66666666X                X          XXXXX M        MXXXXXX
X        X       X        X          XXXXXB          XXXXXX
X99999999D m B   X  m S B D mt      BXXXXXBB         XXXXXX
XXXXXXXXXXXXXXXXXXXXXXXXXXXXXXXXXXXXXXXXXXXXXXXXXXXXXXXXXXX