                            XXXXXXXXXXXXXXXXXXXXXXXXXXXXXXX
                            XXXXXX                        X
XXXXXXXXXXXXXXXXXXXXXXXXXXXXXXXXXX                       @X
XXXXXXXXXXXXXXXXXXXXXXXXXXXXXXX2XX       m           XXXXXX
X 12345  X  aesq          X          XXXXX M        MXXXXXX
X 67890  X  zx     X        X          XXXXXB          XXXXXX
X99999999D mcv   X  m S B D mt      BXXXXXBB         XXXXXX
XXXXXXXXXXXXXXXXXXXXXXXXXXXXXXXXXXXXXXXXXXXXXXXXXXXXXXXXXXX