XXXXXXXXXXXXXXXXXXXXXXXXX
X        X             XX
X        X             XX
XP      TX             XX
XXXXXRRRXXXXXXXXXXXXX  XX
X        XXXXXXXXXX    XX
X        XXXXXXXXXX    XX
X        XXXXXXXXXX    XX
X                      XX
XL  B            S    MXX
XXXXXXXXXXXXXX  XXXrrr XX
XXXXXXXXXXXXXXX    E   XX
XXXXXXXXXXXXXXXXXXXXXXXXX