                            XXXXXXXXXXXXXXXXXXXXXXXXXXXXXXX
                            XXXXXX                        X
XXXXXXXXXXXXXXXXXXXXXXXXXXXXXXXXXX                       @X
XXXXXXXXXXXXXXXXXXXXXXXXXXXXXXX2XX       m           XXXXXX
X 12345  X  aesq          X          XXXXX M        MXXXXXX
X 67890  X       X        X          XXXXXB          XXXXXX
X99999999D m B   X  m S B D mt      BXXXXXBB         XXXXXX
XXXXXXXXXXXXXXXXXXXXXXXXXXXXXXXXXXXXXXXXXXXXXXXXXXXXXXXXXXX