XXXXXXXXXXXXXXXXXXXXXXXXX
X       6X6          66XX
X        X             XX
XP  m   TX   @         XX
XXXXXRRRXXXXXXXXXXXXX  XX
X66     6XXXXXXXXXX6   XX
X        XXXXXXXXXX    XX
X                      XX
X         a            XX
XL  B            S    MXX
XXXXXXXXXXXXX   XXXrrr XX
XXXXXXXXXXXXXX  888    XX
XXXXXXXXXXXXXXX99999999XX
XXXXXXXXXXXXXXXXXXXXXXXXX